11
10
###########
#   #*    #
#    *    #
#    -    #
#    -    #
#    *    #
#    *    #
#    H    #
#       + #
###########